9
0OMMIMMMO6OMMMIMMO3
OMMMMIMMMOMMMIMMMMO
MMMMMMMMMMMMMOMMMMM
IIMMMMMMMIMMO8OMMII
MMMMMMMMMIMMMOMMMMM
OMMMMMMMMIMMMMMMMMO
4OMMMMMIIIIIMMMMMO5
OMMMMMMMMIMMMMMMMMO
MMMMMOMMMIMMMMMMMMM
IIMMO9OMMIMMMMMMMII
MMMMMOMMMMMMMMMMMMM
OMMMMIMMMOMMMIMMMMO
2OMMIMMMO7OMMMIMMO1
