7
MMMMMMMMMMMMOMMMMMMMMMMMM
MOOOOOOOMMMO5OMMMOOOOOOOM
MOIIIMIMMMMMOMMMMMIMIIIOM
MOIMMMMMIIIOMOIIIMMMMMIOM
MOIMMMOMMMMMIMMMMMOMMMIOM
MMMMIMMMMOMMIMMOMMMMIMMMM
MMMMIMOMO0OMIMO3OMOMIMMMM
MOMMIMOMMOMMMMMOMMOMIMMOM
O6OMOMMMIIIMMMIIIMMMOMO7O
MOMMIMOMMOMMMMMOMMOMIMMOM
MMMMIMOMO2OMIMO1OMOMIMMMM
MMMMIMMMMOMMIMMOMMMMIMMMM
MOIMMMOMMMMMIMMMMMOMMMIOM
MOIMMMMMIIIOMOIIIMMMMMIOM
MOIIIMIMMMMMOMMMMMIMIIIOM
MOOOOOOOMMMO4OMMMOOOOOOOM
MMMMMMMMMMMMOMMMMMMMMMMMM
