9
O3OIO1OIO0OIO2OIO4O
MOMIMOMIMOMIMOMIMOM
MMMIMMMIMMMIMMMIMMM
MMMIMMMIMMMIMMMIMMM
MMMIMMMIMMMIMMMIMMM
MMMIMMMIMMMIMMMIMMM
IOOOIOOOIOOOIOOOIOO
OOOOOOOOOOOOOOOOOOO
MIMMMIMMMIMMMIMMMIM
OOOOOOOOOOOOOOOOOOO
OOIOOOIOOOIOOOIOOOI
MMMIMMMIMMMIMMMIMMM
MMMIMMMIMMMIMMMIMMM
MMMIMMMIMMMIMMMIMMM
MMMIMMMIMMMIMMMIMMM
MOMIMOMIMOMIMOMIMOM
O8OIO6OIO5OIO7OIO9O
