9
0OMMMIMMMMMO6OMMIMMMMMMO3
OMMMMIMMMMMMOMMIMMMMMMMMO
MMMMMMIMMMMMMMIMIMMMMMMMM
MMMMMMMIMMMMMIMMOIMMMMMMO
MMMMMMMMIMOMIMMO8OIIIIIIO
IIIIIIIMOIOIMMMMOMMMMMMMO
MMMMMMMIOMMMMMMMMIIIIIIII
OMMMMMMMOOOMMMMMIMMMMMMMO
4OMMMMMMMIOOOOOIMMMMMMMO5
OMMMMMMMIMMMMMOOOMMMMMMMO
IIIIIIIIMMMMMMMMOIMMMMMMM
OMMMMMMMOMMMMIOIOMIIIIIII
OIIIIIIO9OMMIMOMIMMMMMMMM
OMMMMMMIOMMIMMMMMIMMMMMMM
MMMMMMMMIMIMMMMMMMIMMMMMM
OMMMMMMMMIMMOMMMMMMIMMMMO
2OMMMMMMIMMO7OMMMMMIMMMO1
