9
0OMRRRRRRRMO6OMRRRRRRRMO3
OIRIRIRIRIRIOIRIRIRIRIRIO
MRRRRRRRRRRRMRRRMRRRRRRRM
RIRIRIRIRIRIRIRIOIRIRIRIR
RRRRRRRRRRRRRRMO8OMRRRRRR
RIRIRIRIRIRIRIRIOIRIRIRIR
MRRRRRRRRRRRRRRRMRRRRRRRM
OIRIRIRIRIRIRIRIRIRIRIRIO
4OMRRRRRRRRRRRRRRRRRRRMO5
OIRIRIRIRIRIRIRIRIRIRIRIO
MRRRRRRRMRRRRRRRRRRRRRRRM
RIRIRIRIOIRIRIRIRIRIRIRIR
RRRRRRMO9OMRRRRRRRRRRRRRR
RIRIRIRIOIRIRIRIRIRIRIRIR
MRRRRRRRMRRRMRRRRRRRRRRRM
OIRIRIRIRIRIOIRIRIRIRIRIO
2OMRRRRRRRMO7OMRRRRRRRMO1
