7
MIIIIIIIIIIIIIIIIIIIIIIIM
MMMIIIIIIIIIIIIIIIIIIIMMM
MMIMMIIIIIIIIIIIIIIIMMIMM
MMMMIMMIIIIIIIIIIIMMIMMMM
IMO0MMIMOIIIIIIIOMIMM1OMI
IMMOMMMM4OMIIIMO5MMMMOMMI
IIMMMMMMMMIMIMIMMMMMMMMII
IIIIMMMMMMMOOOMMMMMMMIIII
IIMMMMMMMMIMIMIMMMMMMMMII
IMMOMMMM6OMIIIMO7MMMMOMMI
IMO2MMIMOIIIIIIIOMIMM3OMI
MMMMIMMIIIIIIIIIIIMMIMMMM
MMIMMIIIIIIIIIIIIIIIMMIMM
MMMIIIIIIIIIIIIIIIIIIIMMM
MIIIIIIIIIIIIIIIIIIIIIIIM