3
IIIIOO2OOIIII
IIOOOMMMOOOII
IOOMMMIMMMOOI
IOMIMMMMMIMOI
OOMMMMMMMMMOO
OMMMMMIMMMMMO
0MIMMMMMMMIM1
OMMMMMIMMMMMO
OOMMMMMMMMMOO
IOMIMMMMMIMOI
IOOMMMIMMMOOI
IIOOOMMMOOOII
IIIIOO3OOIIII
