9
MMOMMMMMIMO6OMMMOMM
O0OMMM8OMMMOMMMMO3O
MMMMMMOMIMMMMMMMMMM
IIMMMMMMIMMMMRRIMIM
MMMMRRRRIRRRRRRIMIM
OMMMMMMMIRRRMMRIRIO
4OMMMMMMIRRRMMRRMO5
MIIIIIRRIMMMIIIIIMO
MRRMMMRRIMMMMMRRMMM
IIRMMMRRIMOMMMRRMMM
MMMMMMMMIO9MMMRMMMM
O2OMIO7MMMMIRRRMO1O
MOMMIMOMIMMIRRRMMOM
