9
0OMMMMMMIMMO6OMMIMMMMMMO3
OMMMMMMMMMMMOMMMMMMMMMMMO
MMIMMMMMMMIMMMIMMMMMMMIMM
MMMMMMMMMMMMMMMMOMMMMMMMM
MMMMIMMMMMMMIMMO8OMMIMMMM
MMMMMMMMMMMMMMMMOMMMMMMMM
MMMMMMIMMMIMMMIMMMIMMMMMM
OMMMMMMIMIMMMMMIMIMMMMMMO
4OMMMMMMIMMMMMMMIMMMMMMO5
OMMMMMMIMIMMMMMIMIMMMMMMO
MMMMMMIMMMIMMMIMMMIMMMMMM
MMMMMMMMOMMMMMMMMMMMMMMMM
MMMMIMMO9OMMIMMMMMMMIMMMM
MMMMMMMMOMMMMMMMMMMMMMMMM
MMIMMMMMMMIMMMIMMMMMMMIMM
OMMMMMMMMMMMOMMMMMMMMMMMO
2OMMMMMMIMMO7OMMIMMMMMMO1