3
0UOOOOOOOOOOOOOOOOOOOOOU2
KDOOOOOOOOOOOOOOOOOOOOODK
OOOOOOOOOOOOOOOOOOOOOOOOO
OOOOOOOOOOOOOOOOOOOOOOOOO
OOOOOOOOOOOOOOOOOOOOOOOOO
OOOOOOOOOOOOOOOOOOOOOOOOO
OOOOOOOOOOOOOOOOOOOOOOOOO
OOOOOOOOOOOSBSOOOOOOOOOOO
OOOOOOOOOOOBBBOOOOOOOOOOO
OOOOOOOOOOOSBSOOOOOOOOOOO
OOOOOOOOOOOOOOOOOOOOOOOOO
OOOOOOOOOOOOOOOOOOOOOOOOO
OOOOOOOOOOOOOOOOOOOOOOOOO
OOOOOOOOOOOOOOOOOOOOOOOOO
OOOOOOOOOOOOOOOOOOOOOOOOO
KDOOOOOOOOOOOOOOOOOOOOODK
3UOOOOOOOOOOOOOOOOOOOOOU1
