7
IOOIIIIIIIIIIIIIIIIIIIOOI
M0OMMMMMMO4III5OMMMMMMO1M
MIIIIMIIIMOIIIOMIIIMIIIIM
MIPOMMOPIMMMIMMMIPOMMOPIM
MIMIIIIMIIIMIMIIIMIIIIMIM
MIPOMMOPIMMMIMMMIPOMMOPIM
MIIIIMIIIMMIIIMMIIIMIIIIM
MMMOOOOOOOOMMMOOOOOOOOMMM
IIIIIIIIIIMMUMMIIIIIIIIII
MMMOOOOOOOOMMMOOOOOOOOMMM
MIIIIMIIIMMIIIMMIIIMIIIIM
MIPOMMOPIMMMIMMMIPOMMOPIM
MIMIIIIMIIIOIOIIIMIIIIMIM
MIPOMMOPIMMMIMMMIPOMMOPIM
MIIIIMIIIMOIIIOMIIIMIIIIM
M3OMMMMMMO7III6OMMMMMMO2M
IOOIIIIIIIIIIIIIIIIIIIOOI
