7
UMMMMIIIIIMMMMU
MMMIIMO2OMIIMMM
MMIOMMMOMMMOIMM
MIO5OMMMMMO7OIM
MIMOMMMMMMMOMIM
IMMMMMMMMMMMMMI
IOMMMMMMMMMMMOI
I0OMMMMMMMMMO1I
IOMMMMMMMMMMMOI
IMMMMMMMMMMMMMI
MIMOMMMMMMMOMIM
MIO6OMMMMMO4OIM
MMIOMMMOMMMOIMM
MMMIIMO3OMIIMMM
UMMMMIIIIIMMMMU