9
MMMMMMMMMMMMMMMMMMMMMMMMM
MOOOMMOOOMMOOOMMOOOMMOOOM
MO8OMMO4OMMO0OMMO2OMMO6OM
MOOOMMOOOMMOOOMMOOOMMOOOM
MMMMMMMMMMMMMMMMMMMMMMMMM
MMMMMMMMMMMMMMMMMMMMMMMMM
MOOOMMOOOMMOOOMMOOOMMOOOM
MO7OMMO3OMMO1OMMO5OMMO9OM
MOOOMMOOOMMOOOMMOOOMMOOOM
MMMMMMMMMMMMMMMMMMMMMMMMM