9
0OOMOOOOIO6OOOOMOO3
OOOMMMOOOOMMMOOMOOO
MMMMMMOOIOMMMOOMMMM
OOOMMMOOIOMMMOOIOIO
OOROOOOOIOOO8OOIOIO
4OOOOMMMIOOOMMOIOIO
OOOOOMMMIOOOMMOOOO5
OIIIIIOOIOOOIIIIIOO
OOOMMM9OIOOMMMOOOOO
IIOMMMOOIOOMMMOORRO
MMMMMMOOIOOMMMOMMMM
OOOMIOOOOOOIOOOMOOO
2OOMIOO7IOOIOOOMOO1
