1
IIIB9BIII
IIIB0BIII
IIIUPEIII
IIIIIIIII
VV1V2V3VV
VVV4V5VVV
VV6V7V8VV
