9
0OMMMMMMMMMO6OMMMMMMMMMO3
OMMMMMMMMMMMOMMMMMMMMMMMO
MMMMMMMMMMMMMMMMMMMMMMMMM
MMMMMMMMMMMMMMMMOMMMMMMMM
MMMMMMMMMMMMMMMO8OMMMMMMM
MMMMMMMMMMMMMMMMOMMMMMMMM
MMMMMMMMMMMMMMMMMMMMMMMMM
OMMMMMMMMMMMMMMMMMMMMMMMO
4OMMMMMMMMMMMMMMMMMMMMMO5
OMMMMMMMMMMMMMMMMMMMMMMMO
MMMMMMMMMMMMMMMMMMMMMMMMM
MMMMMMMMOMMMMMMMMMMMMMMMM
MMMMMMMO9OMMMMMMMMMMMMMMM
MMMMMMMMOMMMMMMMMMMMMMMMM
MMMMMMMMMMMMMMMMMMMMMMMMM
OMMMMMMMMMMMOMMMMMMMMMMMO
2OMMMMMMMMMO7OMMMMMMMMMO1