9
MMIMMMIMMMIMMMIMMMIMMMIMM
MMIO0OIO7OIO5OIO9OIO3OIMM
MIIIOIIIOIIIOIIIOIIIOIIIM
MMIMMMIMMMIMMMIMMMIMMMIMM
IMMMIMMMIMMMIMMMIMMMIMMMI
OIMIOIMIOIMIOIMIOIMIOIMIO
IMMMIMMMIMMMIMMMIMMMIMMMI
MMIMMMIMMMIMMMIMMMIMMMIMM
MIOIMIOIMIOIMIOIMIOIMIOIM
MMIMMMIMMMIMMMIMMMIMMMIMM
IMMMIMMMIMMMIMMMIMMMIMMMI
OIMIOIMIOIMIOIMIOIMIOIMIO
IMMMIMMMIMMMIMMMIMMMIMMMI
MMIMMMIMMMIMMMIMMMIMMMIMM
MIIIOIIIOIIIOIIIOIIIOIIIM
MMIO2OIO8OIO4OIO6OIO1OIMM
MMIMMMIMMMIMMMIMMMIMMMIMM
