7
OOOOOOOOOOOOOOOOO
OIMMMMMMIMMMMMMIO
OMIMMMMMIMMMMMIMO
OMMIMMMMIMMMMIMMO
OMMMIMMMIMMMIMMMO
OMMMMIOOIOOIMMMMO
OMMMMOI6I3IOMMMMO
OMMMMO0III5OMMMMO
OIIIIIIIIIIIIIIIO
OMMMMO4III1OMMMMO
OMMMMOI2I7IOMMMMO
OMMMMIOOIOOIMMMMO
OMMMIMMMIMMMIMMMO
OMMIMMMMIMMMMIMMO
OMIMMMMMIMMMMMIMO
OIMMMMMMIMMMMMMIO
OOOOOOOOOOOOOOOOO