5
0KBOK5BOBK3
UPBOBUBOBPU
BPBOBOBOBPB
BPBOBOBOBPB
BDBOBOBOBDB
BNBOBOBOBNB
BIBIBIBIBIB
BNBOBOBOBNB
BDBOBOBOBDB
BPBOBOBOBPB
BPBOBOBOBPB
UPBOBUBOBPU
1KBOB4KOBK2
