7
MMMMMMMMMMMMMMMMMMMMMMMMM
0MIMOMIMOMIMOMIMOMIMOMIM2
OOMOOOMOOOMOOOMOOOMOOOMOO
OOOOOOOOOOOOOOOOOOOOOOOOO
IIMIIIMIIIMIIIMIIIMIIIMII
4OOOOOOOOOOOOOOOOOOOOOOO6
MOOOMOOOMOOOMOOOMOOOMOOOM
MMOMMMOMMMOMMMOMMMOMMMOMM
IMMMIMMMIMMMIMMMIMMMIMMMI
MMOMMMOMMMOMMMOMMMOMMMOMM
MOOOMOOOMOOOMOOOMOOOMOOOM
7OOOOOOOOOOOOOOOOOOOOOOO5
IIMIIIMIIIMIIIMIIIMIIIMII
OOOOOOOOOOOOOOOOOOOOOOOOO
OOMOOOMOOOMOOOMOOOMOOOMOO
3MIMOMIMOMIMOMIMOMIMOMIM1
MMMMMMMMMMMMMMMMMMMMMMMMM
