5
PMMIIIIIMMP
MMMIIIIIMMM
BMMIIIIIMMB
2BPIIIIIPB3
BMMIIIIIMMB
MMMIIIIIMMM
MMMIIIIIMMM
BMMIIIIIMMB
0BPIIIIIPB1
BMMIIIIIMMB
MMMIIIIIMMM
MMMIIIIIMMM
BMMIIIIIMMB
4BPIIIIIPB5
BMMIIIIIMMB
MMMIIIIIMMM
PMMIIIIIMMP