9
6PMMPIPMMP7
M2PMMIMMP3M
MM0PMIMP1MM
MMM4PIP5MMM
PMMP8I9PMMP
